ack	ack	
affirm	affirm	
api_call	api_call	
bye	bye	
canthear	canthear	
canthelp_type_of_grammar_error_correction	canthelp_type_of_grammar_error_correction	
canthelp_type_of_grammar_error_correction_type_of_text_summarization	canthelp_type_of_grammar_error_correction_type_of_text_summarization	
canthelp_type_of_sentence_division_terms	canthelp_type_of_sentence_division_terms	
canthelp_type_of_sentence_division_terms_type_of_grammar_error_correction	canthelp_type_of_sentence_division_terms_type_of_grammar_error_correction	
canthelp_type_of_sentence_division_terms_type_of_grammar_error_correction_type_of_text_summarization	canthelp_type_of_sentence_division_terms_type_of_grammar_error_correction_type_of_text_summarization	
canthelp_type_of_sentence_division_terms_type_of_text_summarization	canthelp_type_of_sentence_division_terms_type_of_text_summarization	
confirm	confirm	
confirm-domain	confirm-domain	
deny	deny	
expl-conf_type_of_grammar_error_correction	expl-conf_type_of_grammar_error_correction	
expl-conf_type_of_sentence_division_terms	expl-conf_type_of_sentence_division_terms	
expl-conf_type_of_text_summarization	expl-conf_type_of_text_summarization	
hello	hello	
impl-conf_type_of_grammar_error_correction+impl-conf_type_of_text_summarization+request_type_of_sentence_division_terms	impl-conf_type_of_grammar_error_correction+impl-conf_type_of_text_summarization+request_type_of_sentence_division_terms	
impl-conf_type_of_grammar_error_correction+request_type_of_sentence_division_terms	impl-conf_type_of_grammar_error_correction+request_type_of_sentence_division_terms	
impl-conf_type_of_sentence_division_terms+impl-conf_type_of_text_summarization+request_type_of_grammar_error_correction	impl-conf_type_of_sentence_division_terms+impl-conf_type_of_text_summarization+request_type_of_grammar_error_correction	
inform	inform	
inform_average_number_of_words+inform_number_of_total_words+offer_number_of_keyword_extraction	inform_average_number_of_words+inform_number_of_total_words+offer_number_of_keyword_extraction	
inform_average_number_of_words+inform_type_of_text_summarization+offer_number_of_keyword_extraction	inform_average_number_of_words+inform_type_of_text_summarization+offer_number_of_keyword_extraction	
inform_average_number_of_words+offer_number_of_keyword_extraction	inform_average_number_of_words+offer_number_of_keyword_extraction	
inform_number_of_sentences+inform_average_number_of_words+inform_type_of_text_summarization+offer_number_of_keyword_extraction	inform_number_of_sentences+inform_average_number_of_words+inform_type_of_text_summarization+offer_number_of_keyword_extraction	
inform_number_of_sentences+inform_average_number_of_words+offer_number_of_keyword_extraction	inform_number_of_sentences+inform_average_number_of_words+offer_number_of_keyword_extraction	
inform_number_of_sentences+inform_number_of_total_words+offer_number_of_keyword_extraction	inform_number_of_sentences+inform_number_of_total_words+offer_number_of_keyword_extraction	
inform_number_of_sentences+inform_type_of_grammar_error_correction+offer_number_of_keyword_extraction	inform_number_of_sentences+inform_type_of_grammar_error_correction+offer_number_of_keyword_extraction	
inform_number_of_sentences+inform_type_of_text_summarization+offer_number_of_keyword_extraction	inform_number_of_sentences+inform_type_of_text_summarization+offer_number_of_keyword_extraction	
inform_number_of_sentences+offer_number_of_keyword_extraction	inform_number_of_sentences+offer_number_of_keyword_extraction	
inform_number_of_total_words+inform_type_of_text_summarization+offer_number_of_keyword_extraction	inform_number_of_total_words+inform_type_of_text_summarization+offer_number_of_keyword_extraction	
inform_number_of_total_words+offer_number_of_keyword_extraction	inform_number_of_total_words+offer_number_of_keyword_extraction	
inform_type_of_grammar_error_correction+inform_type_of_text_summarization+offer_number_of_keyword_extraction	inform_type_of_grammar_error_correction+inform_type_of_text_summarization+offer_number_of_keyword_extraction	
inform_type_of_grammar_error_correction+offer_number_of_keyword_extraction	inform_type_of_grammar_error_correction+offer_number_of_keyword_extraction	
inform_type_of_sentence_division_terms+inform_average_number_of_words+offer_number_of_keyword_extraction	inform_type_of_sentence_division_terms+inform_average_number_of_words+offer_number_of_keyword_extraction	
inform_type_of_sentence_division_terms+inform_number_of_total_words+offer_number_of_keyword_extraction	inform_type_of_sentence_division_terms+inform_number_of_total_words+offer_number_of_keyword_extraction	
inform_type_of_sentence_division_terms+inform_type_of_grammar_error_correction+inform_type_of_text_summarization+offer_number_of_keyword_extraction	inform_type_of_sentence_division_terms+inform_type_of_grammar_error_correction+inform_type_of_text_summarization+offer_number_of_keyword_extraction	
inform_type_of_sentence_division_terms+inform_type_of_grammar_error_correction+offer_number_of_keyword_extraction	inform_type_of_sentence_division_terms+inform_type_of_grammar_error_correction+offer_number_of_keyword_extraction	
inform_type_of_sentence_division_terms+inform_type_of_text_summarization+offer_number_of_keyword_extraction	inform_type_of_sentence_division_terms+inform_type_of_text_summarization+offer_number_of_keyword_extraction	
inform_type_of_sentence_division_terms+offer_number_of_keyword_extraction	inform_type_of_sentence_division_terms+offer_number_of_keyword_extraction	
inform_type_of_text_summarization+offer_number_of_keyword_extraction	inform_type_of_text_summarization+offer_number_of_keyword_extraction	
negate	negate	
offer_number_of_keyword_extraction	offer_number_of_keyword_extraction	
repeat	repeat	
reqalts	reqalts	
reqmore	reqmore	
request	request	
request_type_of_grammar_error_correction	request_type_of_grammar_error_correction	
request_type_of_sentence_division_terms	request_type_of_sentence_division_terms	
request_type_of_text_summarization	request_type_of_text_summarization	
restart	restart	
select_type_of_grammar_error_correction	select_type_of_grammar_error_correction	
select_type_of_sentence_division_terms	select_type_of_sentence_division_terms	
select_type_of_text_summarization	select_type_of_text_summarization	
thankyou	thankyou	
welcomemsg	welcomemsg	
